000000001111000000000000000000000000000000000000000000000000
000001111111111111111111111111110000000011111111111113311110
000011111111111111111111111111111000000111111111111133331110
000111111111111111111111111111111100001111111111111333333110
000111111101111111111110000011111110011111111110013333333310
000111111001111111111110000111111111111111111110033333333330
000111111001111111111111111111111111111111111110133333333330
000111111001111111111111111111111111111111111101113333333310
000111111001111111111111111111111111111111111011111333333110
000000000001111111111111111111111111111111110111111133331110
000000000001111111111111111100011111111111101111111113311110
000000000011111111111111111000001111111111011111111110011110
011111111111111111111111110000001111111111111111111100011110
011111111111111111111111110000001111111111111111111011111110
011111111111111111111111111000011111111111111111110111111110
011111111111111110001111111100111111111111111111101111111110
011111111111111100000111111111111111101111111111011111111110
011111111111111000000111111111111111011111111110111111111110
011111011111111000000111111111111110111111111101111111111110
011111011111111100001111111111111101111111111011111111111100
011111111111111110011111111111111011111111110111111111111000
011111111111111111111111111111110111111111101111111111110000
011111111110111111111111111111101111111111111111111111110000
011111111100111111111111111111011111111111111111111111111000
011111111100111111111111110000111111111111111111111111111100
011111111100111111111111100111111111111111111111101111111110
011111111111111111111111001111111111110111111111001111111110
011111111111111111111111011111111111101111111111001111111110
011111111111111111111111011111111111011111111111001111111110
011111111111111111111111011111111110111111111111111111111110
011111111110111111111110111111111101111111111111111111111110
011111111100111111111101111111111101111111111111111111111110
011111111100111111111011111111111101111111111111111111111110
011111111100111111111111111111111101111111111111101111111110
001111111111111111111111111111111011111111111111001111111110
000111111111111111111111111110000111111111111111001111111110
000011111111111111111111111101111111111111111111001111111110
000011111111111101111111111011111111111111111111111111111110
000011111111111011111114110111111111111111111111111111111110
000111111111110111111111101111411411111110001111111111111110
001111111111101111141411011111111111111100000111111111011110
011111111111011111111110111141111114111000000111111111111110
011111111110111114111101111111111111111000000111411111111110
011111111101111111111111111111111111411100001111111111111110
011111111011111411111111111111000111111110011114111111111110
011111110111111111111111111110000011141111111111111111111110
011111101111141111111111111100000011111141141111111111111110
011100011111111110111111111100000011111111111111110000000000
011100111111111101111111111110000111111141141111100000000000
011111111411111011111111111111001111111111111111100000000000
011112111111110111111111111111111111111141141111100111111000
011122211111101111111111111111111111111111111111100111111000
011222221111011111111111111111111111111111111111100111111000
012222222110011111111111111111111111111111111111100111111000
012222222220011111111111111111111000001111111111100111111000
012222222211111111111111000111111000011111111111111111111000
012222222111111111111110000011111111111111111111111111111000
011222221111111111111100000001111111111111111111111111110000
011111111111111111111000000000111111111111111111111111100000
000000000000000000000000000000000000000000000000011100000000