000000001111000000000000000000000000000000000000000000000000
000001111111111111111111111111110000000011111111111113311110
000011111111141111111114111411111000000111111111111133331110
000141141111111111111111111111111100001111111111111333333110
000414414101111111141110000014111110011114111110013333333310
000141141001111111111110000111111111111111111110033333333330
000141141001111111111111111111141111111411111110133333333330
000414414001111111111111111111111111111111111101113333333310
000141141001111141141111111111111411141111111011111333333110
000000000001111111111111111111111111111111110111111133331110
000000000001111111111111111100011111111111101111111113311110
000000000011111141141111111000001111111111011111411110011110
011111111111111111111141110000001111111111111111111100011110
011111111111141111111111110000001111111111111111111011111110
011114114111111111111111111000011111111111111111110111111110
011141111111111110001114111100111111111111114111101111111110
011411111111411100000111111111111111101111111111011111111110
011111111111111000000111111111111111011111411110111111111110
011111011111111000000111411111114110111111111101111111111110
011411011111411100001111111111111101111141111011111114111100
011111111111111110011111111411411011111111110111111111111000
011111111111111111111111111111110111414111101111111111110000
011111111110114111111111111111101111111111111111111114110000
011111111100111111111111111111011141114111111111111111111000
011111111100111111111111110000111111111111111111111111111100
011111111100114111111111100111111111411111111111101114111110
011111111111111111111111001111111111110111111111001111111110
011111111111111111411111011114411111101111111111001111111110
011141141111411141114111011141141111011114111111001141141110
011111111111111111111111011414414110111411141111111111111110
011111111110111141114110111414414101111111111111111111111110
011141141100111111411101111141141101111411141114111141141110
011111111100111111111011111114411101111114111111111111111110
011111111100111111111111111111111101111111111111101111111110
001111411111111111111114111111111011111111111411001111111110
000111111111111111111111111110000111111111111111001111111110
000011111111111111111411141101111111111111111111001111111110
000011411111111101111111111011111111111111111411111111111110
000011111111111011111414110111111111111111111111111111111410
000111111111110111111111101114114111111110001111111111111110
001111411111101111141111011111111111111100000114111111011110
011111111111011111111110111411111114111000000111111111111410
011111111110111114111101111111111111111000000111111111114110
011111111101111111111111111111111111111100001114111141141110
011111111011111411111111111111000111411110011111111111111110
011111110111111111111111111110000011111111111111111111111110
011111101111111111111111111100000011111111111141111111111110
011100011111111110111111111100000011141111111111110000000000
011100111114111101111111111110000111111141141111100000000000
011111111111111011111111111111001111111111111111100000000000
011112111111110111111111111111111111111111111111100111111000
011122211111101111111141114111111111111111111111100141141000
011222221111011111111111111111111111111111111111100414414000
012222222110011111114111111141111111111141141111100141141000
012222222220011111111111111111111000001111111111100141141000
012222222211111111411111000111411000011111111111111414414000
012222222111111111111110000011111111111141141111111141141000
011222221111111111111100000001114111411111111141111111110000
011111111111111111111000000000111111111111111111111111100000
000000000000000000000000000000000000000000000000011100000000