000000000000000000000000000000000000000000000000000000000000
000000000000000000000000000000000000000000000000000000000000
000000000000000000000000000000000000000000000000000000000000
000000000000000000000000000000000000000000000000000000000000
000000000000000000000000000000000000000000000000000000000000
000000000000000000000000000000000000000000000000000000000000
000000000000000000000000000000000000000000000000000000000000
000000000000000000000000000000000000000000000000000000000000
000000000000000000000000000000000000000000000000000000000000
000000000000000000000000000000000000000000000000000000000000
000000000000000000000000000000000000000000000000000000000000
011111111111110011111111111111111111111111111001111111111110
011111111111111111111111111111111111111111111111111111111110
011111111111111111111111111111111111111111111111111111111110
011111101111111111111111110111111101111111111111111110111110
011111000111111111111111111111111111111111111111111100011110
011110000011111111111111111111111111111111111111111000001110
011110000111111111111111111111111111111111111111111000011110
011111001111111111110111111111111111111101111111111100111110
011111111111111111100011111111111111111000111111111111111110
011111111111111111000001111111111111110000011111111111111110
011111111111111111000011111111111111110000111111111111111110
000111111111111111100111111111111111111001111111111111111100
000011111111111111111111111111011111111111111111111111111000
000001111111111111111111111110001111111111111111111111110000
000011111111111111111111111110011111111111111111111111110000
000111111111111111111111111111111111111111111111111111111000
001111110111111111111111111111111111111111111111111101111100
011111111111111111111111111111111111111111111111111111111110
011111111111111111111111111111111111111111111111111111111110
011111111111111111111111111111111111111111111111111111111110
011111111111111110000001111111111111110000001111111111111110
011111111111111100000000111111111111100000000111111111111110
011111011111111000000000011111111111000000000011111111011110
011111111111110000000000001111111110000000000001111111111110
011111111111110001333100011111111110001222100011111111111110
011111111111111113333311111111111111112222211111111111111110
011111111111111133333331111111111111122222221111111111111110
011111111111111133333331111111111111122222221111111111111110
011111011111111133333331111111111111122222221111111111011110
011111111111111113333311111111111111112222211111111111111110
011111111111110000333100001111111110000222100001111111111110
001111111111110000000000011111111110000000000011111111111110
000111111111111000000000111111111111000000000111111111111100
001111111111111100000001111111111111100000001111111111111100
011111110111111110000011111111111111110000011111111101111110
011111111111111111111111111111111111111111111111111111111110
011111111111111111111111111111111111111111111111111111111110
011111111111111111111111111111111111111111111111111111111110
011111111111111111111111111111111111111111111111111111111110
011111111111111111111001111111111111110011111111111111111110
011111110111111111110000111111011111100001111111111101111110
011111111111111111100000111111111111000001111111111111111110
011111111111111111110001111111111111100011111111111111111110
001111111111111111111011111111111111110111111111111111111110
000111111111111111111111111111111111111111111111111111111100
001111111111110111111111111111111111111111111101111111111100
011111111111111111111111111111111111111111111111111111111110
011111111111111111111111111111111111111111111111111111111110
011111111111111111111111110111111101111111111111111111111110
011111100111111111111111100011111000111111111111111100111110
011111000011111111111111100111111001111111111111111000011110
011110000011111111111111111111111111111111111111110000011110
011111000111111111111111111111111111111111111111111000111110
011111101111111111111111111111111111111111111111111101111110
011111111111111111111111111111111111111111111111111111111110
001111111111111111111111111111111111111111111111111111111110
000111111111101111111101111111111111101111111101111111111100
000011111111000111111000111111111111000111111000111111111000
000000000000000000000000000000000000000000000000000000000000