111111111411141114111411141114111411141114111111111
111111141114111411141114111411141114111411141111111
111111111411141114111411141114111411141114111111111
111111111111111111111111111111111111111111111111111
111111111111111111111111111111111111111111111111111
111111111111111111111111111111111111111111111111111
111111111111111111111111111111111111111111111111111
111111111111111111111111111111111111111111111111111
111111111111111111111111111111111111111111111111111
111111111111111111111111111111111111111111111111111
000000000000000000000000000000000000000000000000000
000000000000000001000000141000000100000000000000000
000000000000000001000000111000000100000000000000000
011111111111111111000000141000000100000000000000001
014111111141101411222222111333333114101141111111411
011111111414101111222222141333333111101414111111111
011111114141401411222222111333333114104141411111111
011100011111111111222222141333333111111111110001111
011100014141411411111111111111111114114141410001111
011111111414111111111111141111111111111414111111111
011111111141101411111111111111111114101141111111111
011111111111101111111111141111111111101111111111111
014111111111111111000011111111111111111111111111411
011111111111111111000011141111111111111111110000111
014101111111111111111111111111111111111111110000411
011101111111111111111111141111111111111111111101111
014111110000000000111111111111111000000000011111411
011101110000000000111111141111111000000000011111111
011101111111111111111111110000111000000000011101111
011101111111111111111111140000111111111111111101111
014111111111111111111111111111111111111111111111411
011111411111111110000111141000011111111111114111111
011101111111111110000111111000011111111111111101111
011101410000000000111111000111111000000000014101111
011111110000000000111111000111111000000000011111111
011111110000000000111111404111111000000000011111111
011111411411111411111141111141111114111114114100001
011111111111111111011111111111110111111111111100001
011111111111111111011411111114110111111111111111111
000001111111110111111111111111111111011111111111111
000001111111110111111411010114111111011111111111111
011111111101111111111111000111111111111101111111111
011111111101111141411141000141114141111101111110000
011111011111114111114111414111411111411111110110000
011111011111111111111110000111111111111111110111111
014111111111141111111410000114111111141141111111411
011111111111111111111111111111111111111111111111111
111111111111141101011411141114110101141111111111111
111111111111111100011111111111110001111111111111111
114111111111114100014111111111410001411111111111411
111111111111111141411111111111114141111111111111111
114111111111111111111111111111111111111111111111411
111111111111111114111111111111111411111111111111111
114111111111111411141111010111141114111111111111411
111111111111111111111111000111111111111111111111111
114111100111111410141111000111141014111111001111411
111100000000100004111111111111111410000000000001111
114100000000100001111111141111111110000000000001411
011100000000111111111111111111111111111000000001111
011111111111111111111111111111111111111111111111111