000000000000000000000000000000000000000000000000000
000000000000000000000000000000000000000000000000000
000000000000000000000000000000000000000000000000000
011111111111111111111111111111111111111111111111110
011111111111111111111000000000001111111111111111110
011111111111111111111000000000001111111111111111110
011111000001111111111000000000001111111100000111110
011111000001111111111000000000001111111100000111110
011111000001111111111000000000001111111100000111110
011111000001111111111000000000001111111100000111110
011111000001111111111000000000001111111100000111110
011111000001111111111000000000001111111100000111110
011111000001111111111000000000001111111100000111110
011111000001111111111000000000001111111100000111110
011111000001111111111000000000001111111100000111110
011111111111111111111000000000001111111111111111110
011111111111111111111111111111111111111111111111110
011111111111111111111111111111111111111111111111110
011111111111111111111111111111111111111111111111110
011100000000000000000011111111100000000000000001110
000000000000000000000011111111100000000000000000000
000000000000000000000011111111100000000000000000000
022222221111111111111111111111111111111111133333330
022222221111111111111111111111111111111111133333330
022222221111111111111111111111111111111111133333330
022222221111111111111111111111111111111111133333330
022222221111111111111111111111111111111111133333330
001111100000111000000001111111000000011100001111100
000111000000111000000001111111000000011100000111000
000111000000111000000001111111000000011100000111000
000111000000111000000001111111000000011100000111000
000111000000111000000001111111000000011100000111000
000111000000111000000001111111000000011100000111000
000000000000111000000001111111000000011100000111000
000000000000111000000001111111000000011100000111000
000000000000111000000001111111000000011100000111000
000000000000111000000001111111000000011100000111000
011111111111111111111111111111111111111111111111110
011111111111111111111111111111111111111111111111110
011111111111111111111111111111111111111111111111110
011111110000000000000000000000000000000000111111110
011111110000000000000000000000000000000000111111110
011111110000000000000000000000000000000000111111110
011111110000000000000000000000000000000000111111110
011111110000000000000000000000000000000000111111110
011111110000000000000000000000000000000000111111110
011111111111111111111111111111111111111111111111110
011111111111111111111111111111111111111111111111110
011111111111111111111111111111111111111111111111110
000000000000000000000000000000000000000000000000000
111111111111111111111111111111111111111111111111111
111111111111111111111111111111111111111111111111111
111111111111111111111111111111111111111111111111111
111111111111111111111111111111111111111111111111111
000000000000000000000000000000000000000000000000000
000000000000000000000000000000000000000000000000000
000000000000000000000000000000000000000000000000000
000000000000000000000000000000000000000000000000000
000000000000000000000000000000000000000000000000000
000000000000000000000000000000000000000000000000000