000000000000000000000000000000000000000000000000000
000000000000000000000000000000000000000000000000000
000000000000000000000000000000000000000000000000000
000000000000000000000000000000000000000000000000000
000000000000000000000000000000000000000000000000000
000000000000000000000000000000000000000000000000000
000000000000000000000000000000000000000000000000000
000000000000000000000000000000000000000000000000000
000000000000000000000000000000000000000000000000000
000000000000000000000000000000000000000000000000000
000000000000000000000000000000000000000000000000000
000000000000000000000000010000000000000000000000000
000000000000000000000000010000000000000000000000000
011111111111111110000000010000000000000000000000000
011100011111101110222222010333333011101111110001110
011100011111101110222222010333333011101111110001110
011100011111101110222222010333332011101111110001110
011100011111111110222222010222222011111111110001110
011100011111111110111111010111111011111111110001110
011111111111101111111111010111111111101111111111110
011111111111101111111111010111111111101111111111110
011111111111101110111111010111111011101111111111110
011111111111111110000011010111111011111111111111110
011101110000000000000011010111111000000000010000110
011101110000000000111111010111111000000000010000110
011101110000000000111111010111111000000000011101110
011111110000000000111111010111111000000000011111110
011101110000000000111111010111111000000000011101110
011101111111111111111111010000111000000000011101110
011101111111111111111111010000111111111111111101110
011111110000000000111111010111111000000000011111110
011101110000000000000111010000011000000000011101110
011101110000000000000111000000011000000000011101110
011101110000000000111111000111111000000000011101110
011111110000000000111111000111111000000000011111110
011111110000000000111111000111111000000000011111110
011111111111111111011111111111110111111111111100000
011111111111111111011111111111110111111111111100000
011111111111110111011111000111110111011111111111110
000001111111110111111111000111111111011111111111110
000001111101110111111111000111111111011101111111110
011111111101111111111111000111111111111101111111110
011111011101111111111111000111111111111101110110000
011111011111111111111111111111111111111111110110000
011111011111111111111110000111111111111111110111110
011111111111111100011110000111110001111111111111110
011111111111111100011111111111110001111111111111110
011100011000111100011111111111110001111000110001110
011100011000111100011111111111110001111000110001110
011100011000111100011111111111110001111000110001110
011100011000111111111111111111111111111000110001110
011100011000111111111111000111111111111000110001110
011100011000111111111111000111111111111000110001110
011100011000111111111111000111111111111000110001110
011100011000111110111111000111111011111000110001110
011100000000111110111111000111111011111000000001110
011100000000100000111111111111111010000000000001110
011100000000100001111111111111111110000000000001110
011100000000111111111111111111111111111000000001110
000000000000000000000000000000000000000000000000000