111111111411141114111411141114111411141114111111111
111111141114111411141114111411141114111411141111111
111111111411141114111411141114111411141114111111111
111111111111111111111111111111111111111111111111111
111111111111111111111111111111111111111111111111111
111111111111111111111111111111111111111111111111111
111111111111111111111111111111111111111111111111111
111111111111111111111111111111111111111111111111111
111111111111111111111111111111111111111111111111111
111111111111111111111111111111111111111111111111111
000000000000000000000000000000000000000000000000000
011111111111111110111111040111111011111111111111110
011111111111111110111111010111111011111111111111110
011111111111111110222222040333333011111111111111110
014100011141101410222222010333333014101141110001410
011100011414111110222222040333333011111414110001110
011100014141411410222222010333333014114141410001110
011111111111111110222222040333333011111111111111110
011111114141411410111111010111111014114141411111110
011111111414101111111111040111111111101414111111110
011111111141111411111111010111111114111141111111110
011111111111111110111111040111111011111111111111110
014111111111111110111111010111111011111111111111410
011101110000000000111111040111111000000000011101110
014111110000000000111111010111111000000000011111410
011111110000000000111111040111111000000000011111110
014111110000000000111111010111111000000000011111410
011101111111111111111111040111111111111111111101110
011111111111111111111111010111111111111111111111110
011111111111111111111111040111111111111111111111110
014111110000000000111111010111111000000000011111410
011101410000000000111111040111111000000000014101110
011111110000000000111111000111111000000000011111110
011111411111111111111111111111111111111111114111110
011111111111111111111111111111111111111111111111110
011111111111111111111111414111111111111111111111110
011111411411111411011141111141110114111114114111110
011111111111111111111111111111111111111111111111110
011111111111110111111411000114111111011111111111110
011111111111111111111111000111111111111111111111110
011111111101111111111411000114111111111101111111110
011111111111111111111111111111111111111111111111110
011111011111111141411141111141114141111111110111110
011111111111114111114111414111411111411111111111110
011111111111111111111111111111111111111111111111110
014111111111141100011411111114110001141141111111410
011111111111111100011111111111110001111111111111110
011100011000141100011411141114110001141000110001110
011100011000111111111111111111111111111000110001110
014100011000114111114111111111411111411000110001410
011100011000111141411111111111114141111000110001110
014100011000111111111111000111111111111000110001410
011100011000111114111111000111111411111000110001110
014100011000111411141111000111141114111000110001410
011100011000111110111111111111111011111000110001110
014100011000111411141111111111141114111000110001410
011111111111111114111111111111111411111111111111110
014111111111111111111111141111111111111111111111410
011111111111111111111111111111111111111111111111110
000000000000000000000000000000000000000000000000000