000000000000000000000000000000000000000000000000000000000000
040404040404040404040000000000000000000040404040404040404040
000000000000000000000000000000000000000000000000000000000000
004040404040404040404000000000000000000404040404040404040400
000000000000000000000000000000000000000000000000000000000000
000000000000000000000000000000000000000000000000000000000000
000000000000000000000000000000000000000000000000000000000000
000000000000000000000000000000000000000000000000000000000000
000000000000000000000000000000000000000000000000000000000000
000000000000000000000000000000000000000000000000000000000000
000000000000000000000000000000000000000000000000000000000000
011111111111110011111111111111111111111111111001111111111110
014141111141111111141114111411141114111411111111114111141410
011111111111111111111111111111111111111111111111111111111110
014141101111411111111111110111111101111111111111411110141410
011111000111111111111111111111111111111111111111111100011110
011110000011111111411411111111111111114114111111111000001110
011110000111111111111111111111111111111111111111111000011110
011111001111111111110111111111111111111101111111111100111110
011411111111111411100011411111111114111000114111111111114110
011111111111111111000001111111111111110000011111111111111110
011114111111111111000011111111111111110000111111111111411110
000111111111111411100111411111111114111001114111111111111100
000011111111111111111111111111011111111111111111111111111000
000001111111111111111111111110001111111111111111111111110000
000011111141111111411411111110011111114114111111141111110000
000111111111111111111111111111111111111111111111111111111000
001111110114111111111111114111111411111111111111411101111100
011111111111111111111111111111111111111111111111111111111110
011111111141111141411111111111111111111114141111141111111110
011111114111111111111111111111111111111111111111111411111110
011141111111111110000001111141141111110000001111111111141110
011111111111111100000000111111111111100000000111111111111110
011111011111411000000000011111111111000000000014111111011110
011111111111110000000000001111111110000000000001111111111110
011411111111110001333100011111111110001222100011111111114110
011111111111111113333311111111111111112222211111111111111110
011111141111111133333331111111111111122222221111111141111110
011111111111111133333331111141141111122222221111111111111110
011111011111111133333331111111111111122222221111111111011110
011111111111111113333311111111111111112222211111114111111110
011111114111110000333100001111111110000222100001111111111110
001111111111110000000000011111111110000000000011111141111110
000111411111411000000000111111111111000000000114111111111100
001111111111111100000001111111111111100000001111111111111100
011111110111111110000011111411114111110000011111111101111110
011111111111111111111111111111111111111111111111111111111110
011111111111111141411111111111111111111114141111111111111110
011111141111111111111111111111111111111111111111111141111110
011114111111414111111111111111111111111111111414111111411110
011111111114111411111001111111111111110011114111411111111110
011111110111111111110000141111011141100001111111111101111110
011111111114111411100000111111111111000001114111411111111110
011114111111414111110001111111111111100011111414111111411110
001111111111111111111011111111111111110111111111111111111110
000111111111111111111111141111111141111111111111111111111100
001111111111110111111111111111111111111111111101111111111100
011111111411111111111111111111111111111111111111114111111110
011111111111111114111411111141141111114111411111111111111110
011111111111111111111111110111111101111111111111111111111110
011111100111141111111111100011111000111111111141111100111110
011111000011111111111111100111111001111111111111111000011110
011110000011111111111111111111111111111111111111110000011110
011111000111114111411111111141141111111114111411111000111110
011141101111111111111111111111111111111111111111111101141110
011414111111411111111141114111111411141111111114111111414110
001141111111111111111111111111111111111111111111111111141110
000111111111101111111101111111111111101111111101111111111100
000011111111000111111000111111111111000111111000111111111000
000000000000000000000000000000000000000000000000000000000000