000000000000000000000000000000000000000000000000000
011111111111111111111141414141411111111111111111110
011111411141111141414114111114114141111141114111110
011411111111141111111141414141411111141111111114110
011114111114111111111000000000001111111411111411110
014111111111114111111000000000001111411111111111410
011141000001411111111000000000001111114100000141110
011111000001111111111000000000001111111100000111110
011111000001111111111000000000001111111100000111110
014111000001114111111000000000001111411100000111410
011141000001411111111000000000001111114100000141110
011111111111111111111000000000001111111111111111110
011111111111111111111111111111111111111111111111110
014111111111114111111111111111111111411111111111410
011141111111411111111111111111111111114111111141110
011111411141111111111111111111111111111141114111110
011111111111111141114111411141114111411111111111110
011111111111111111111111111111111111111111111111110
041111111111111111111111111111111111111111111111140
011100000000000000000011111111100000000000000001110
022222221111111111111114114111111111111111133333330
022222221111111111111144111111111111111111133333330
022222221111111111111111114111111111111111133333330
022222221111111111111111111111111111111111133333330
022222221111111111114111411141114111111111133333330
022222221111111111111111111111111111111111133333330
022222221111111111111111114111111111111111133333330
001111100000111000000001111111000000011100001111100
000111000000111000000001111111000000011100000111000
000111000000111000000001114111000000011100000111000
000111000000111000000001111111000000011100000111000
000111000000111000000001111111000000011100000111000
000111000000111000000001114111000000011100000111000
000111000000111000000001111111000000011100000111000
011111111111111111111111111111111111111111111111110
011111111111111141411141111111414141411111111111110
011111111111111111111111111111111111111111111111110
011111111111111111111111111111111111111111111111110
011111111111114111411141111111411141114111111111110
011111111111111111111111111111111111111111111111110
011111110000000000000000000000000000000000111111110
011141110000000000000000000000000000000000111141110
011111110000000000000000000000000000000000111111110
014141410000000000000000000000000000000000114141410
011111111111111111111111111111111111111111111111110
014141411114111411141114111411141114111411114141410
011111111111141111111411111114111111141111111111110
011141111114111411141114111411141114111411111141110
011111111111111111111111111111111111111111111111110
000000000000000000000000000000000000000000000000000
111111111111111111111111111111111111111111111111111
111111111111111111111111111111111111111111111111111
111111111111111111111111111111111111111111111111111
111111111111111111111111111111111111111111111111111
111111111111111111111111111111111111111111111111111
111111111111111111111111111111111111111111111111111
111111111111111111111111111111111111111111111111111
111114111411141114111411141114111411141114111411111
114141414141414141414141414141414141414141414141411
111114111411141114111411141114111411141114111411111